15 21 21 21 21 21 21 21 21 21 21 21 21 21 21 21 21 21 21 21 21 21 21 21 21 21 21 21 21 21 21 21 21 21 21 21 21 21 21 21 21 21 21 21 21 21 21 21 21 21 21 18
22 21 21 10 10 10 10 10 10 10 10 10 10 10 10 10 10 10 10 10 21 21 21 21 21 21 21 21 21 10 10 10 21 21 21 21 10 10 10 21 21 21 21 21 21 10 10 10 10 10 22 23
22 21 21 10 10 10 10 10 10 10 10 10 10 10 10 10 10 10 10 10 21 21 21 21 21 21 21 21 21 10 10 10 10 10 10 10 10 10 10 10 10 10 10 10 10 10 10 10 10 10 10 23
22 21 21 10 10 10 10 10 10 10 10 10 10 10 10 10 10 10 10 10 21 21 21 21 21 21 21 21 21 10 10 10 21 21 21 21 10 10 10 10 10 10 10 10 10 10 10 10 10 10 10 23
22 21 21 10 10 10 16 17 10 10 10 22 10 10 10 10 10 10 10 10 21 21 21 21 21 21 21 21 21 10 10 10 21 21 21 21 10 10 10 21 21 10 10 10 10 10 10 10 10 10 10 23
22 21 21 10 10 10 10 10 10 10 10 22 10 10 10 10 10 10 10 10 21 21 21 21 21 21 21 21 21 10 10 10 21 21 21 21 10 10 10 21 21 10 21 21 21 21 21 10 10 10 10 23
22 21 21 10 10 10 10 10 10 10 10 22 10 10 10 10 10 10 10 10 21 21 21 21 21 21 21 21 21 10 10 10 21 21 21 21 10 10 10 21 21 10 21 21 21 21 21 10 10 10 10 23
22 21 21 10 10 10 10 10 10 10 10 10 10 10 10 10 10 10 10 10 10 10 10 10 10 10 10 10 10 10 10 10 21 21 21 21 10 10 10 21 21 10 21 21 21 21 21 10 10 10 10 23
22 21 21 10 10 10 10 10 10 10 10 22 10 10 10 10 10 10 10 10 10 10 10 10 10 10 10 10 10 10 10 10 21 21 21 21 10 10 10 10 10 10 10 10 10 10 10 10 10 10 10 23
22 21 21 21 21 10 10 21 21 21 21 21 10 10 21 21 21 21 21 21 21 21 21 21 10 10 21 21 21 14 14 14 21 21 21 21 10 10 10 10 10 10 10 10 10 10 10 10 10 10 10 23
22 21 21 21 21 10 10 21 21 21 21 21 21 21 21 21 21 21 21 21 21 21 21 21 10 10 21 21 21 10 10 10 10 10 10 10 10 10 10 21 21 21 21 21 21 10 10 10 10 10 10 23
22 10 10 10 10 10 10 10 10 10 10 10 10 10 21 21 21 21 21 21 21 21 10 10 10 10 10 10 10 10 10 10 10 10 10 10 10 10 10 21 21 21 21 21 21 10 10 10 10 10 10 23
22 10 10 10 10 10 10 10 10 10 10 10 10 10 21 21 21 21 21 21 21 21 10 10 10 10 10 10 10 10 10 10 10 10 10 10 10 10 10 21 21 21 21 21 21 10 10 10 10 10 10 23
22 10 10 10 10 10 10 10 10 10 10 10 10 10 21 21 21 21 21 21 21 21 10 10 10 10 10 10 21 21 10 10 10 10 10 10 10 10 10 21 21 21 21 21 21 10 10 10 10 10 10 23
22 10 10 10 10 16 17 10 10 10 10 10 10 10 21 21 21 21 21 21 21 21 10 10 16 17 10 10 21 21 21 21 21 21 21 11 11 11 11 21 21 21 21 21 21 10 10 10 10 21 21 23
22 10 10 10 10 10 10 10 10 10 10 10 10 10 21 21 21 21 21 21 21 21 10 10 10 10 10 10 21 21 21 21 21 21 21 10 10 10 10 21 21 21 21 21 21 10 10 10 10 21 21 23
22 10 10 10 10 10 10 10 10 10 10 10 10 10 21 21 21 21 21 21 21 10 10 10 10 10 10 10 21 21 21 21 21 21 21 10 10 10 10 21 21 21 21 21 21 10 10 10 10 21 21 23
22 10 10 10 10 10 10 10 10 10 10 10 10 10 21 21 21 21 21 21 10 10 10 10 10 10 10 10 21 21 21 21 21 21 21 10 10 10 10 21 21 21 21 21 21 10 10 10 10 21 21 23
22 10 14 14 22 14 14 21 21 21 14 14 14 14 10 10 10 10 10 10 14 14 14 14 21 21 21 21 21 21 21 21 21 10 10 10 10 10 10 21 10 10 10 10 10 10 10 10 21 21 21 23
22 10 10 10 22 10 10 21 21 21 10 10 10 10 10 10 10 10 10 10 10 10 10 10 10 21 21 21 21 21 21 21 10 10 10 10 10 10 10 21 10 10 10 10 10 10 10 10 21 21 21 23
22 10 10 10 22 10 10 21 21 21 21 10 10 10 10 10 10 10 10 10 10 10 10 10 10 21 21 21 21 21 21 21 10 10 10 16 17 10 10 10 10 10 10 10 10 10 10 10 21 21 21 23
22 10 10 10 22 10 10 21 21 21 21 21 10 10 10 10 10 10 10 10 10 10 10 10 10 21 21 21 21 21 21 21 10 10 10 10 10 10 10 10 10 10 10 10 10 10 10 10 21 21 21 23
22 10 10 10 10 10 10 21 21 21 21 21 10 10 10 10 16 17 10 10 10 10 10 10 10 21 21 21 21 21 21 10 10 10 10 10 10 10 10 10 10 10 10 10 10 10 10 10 10 10 21 23
22 10 10 10 10 10 10 21 21 21 21 21 10 10 10 10 10 10 10 10 10 10 10 10 10 21 21 21 21 21 21 10 10 21 21 21 21 21 10 10 10 10 10 10 10 10 10 10 10 10 21 23
22 10 10 21 21 21 10 10 21 21 21 21 10 10 10 10 10 10 10 10 10 10 10 10 10 13 10 10 10 10 10 10 10 21 21 21 21 21 10 10 10 10 10 10 21 21 21 10 10 10 10 23
22 10 10 21 21 21 10 10 10 10 10 10 10 10 10 10 10 10 10 10 10 10 10 10 10 13 10 10 10 10 10 10 21 21 21 21 21 10 10 10 10 10 10 10 21 21 21 10 10 10 10 23
22 10 10 21 21 21 10 10 10 10 10 10 10 10 10 10 10 10 10 10 10 10 10 10 10 13 10 10 10 10 10 10 21 21 21 21 21 10 10 10 21 21 21 21 21 21 21 10 10 10 10 23
22 10 10 21 21 21 10 10 10 21 21 21 21 21 10 10 10 10 10 10 21 21 21 21 21 21 21 10 10 10 10 10 21 21 21 21 21 10 10 21 21 21 21 21 21 21 21 10 10 10 10 23
22 10 10 21 21 10 10 10 21 21 21 21 21 21 10 10 10 10 10 10 10 10 10 10 10 10 10 10 10 10 10 10 21 10 10 10 10 10 10 21 21 21 21 21 21 10 10 10 10 10 10 23
22 10 10 10 10 10 10 21 21 21 21 21 21 21 10 10 10 10 10 10 10 10 10 10 10 10 10 10 10 10 10 10 21 10 10 10 10 10 10 21 10 10 10 10 10 10 10 10 10 10 10 23
22 10 10 10 10 10 10 21 21 21 21 21 21 21 10 10 10 10 10 10 10 10 10 10 10 10 10 10 10 10 10 10 21 21 10 10 10 10 10 21 10 10 10 10 10 10 10 10 10 10 10 23
22 21 21 10 10 10 10 21 21 21 21 21 21 10 10 10 10 10 10 10 10 10 21 21 21 21 21 10 10 10 10 10 21 21 10 10 10 10 10 21 10 10 10 10 10 10 10 10 10 21 21 23
22 21 21 10 10 10 10 21 21 21 21 21 10 10 10 10 10 10 10 10 10 10 10 21 21 21 21 10 10 10 10 10 21 21 10 10 10 10 10 21 10 10 10 10 10 10 10 21 21 21 21 23
22 21 21 10 10 10 10 10 10 10 10 10 10 10 10 10 10 16 17 10 10 10 10 10 21 21 21 10 10 10 10 10 21 21 10 10 10 10 10 21 10 10 10 10 10 10 10 21 21 21 21 23
22 21 21 10 10 10 10 10 10 10 10 10 10 10 10 10 10 10 10 10 10 10 10 10 21 21 21 10 10 10 10 10 21 21 10 10 10 10 10 10 10 10 10 10 10 10 10 21 21 21 21 23
22 21 21 10 10 10 10 10 21 21 21 10 10 10 10 10 10 10 10 10 10 10 10 10 10 10 10 10 10 10 10 10 21 21 10 10 10 10 10 10 10 10 10 10 10 10 10 21 21 21 21 23
22 21 21 10 10 10 10 10 21 21 21 10 10 21 10 10 10 10 10 10 10 10 21 10 10 10 10 10 10 10 10 10 10 10 10 10 10 10 10 10 10 10 10 10 10 10 10 21 21 21 21 23
22 21 21 10 10 10 10 10 21 21 10 10 10 21 21 10 10 10 10 10 10 21 10 10 10 21 21 21 21 10 10 10 21 21 10 10 10 10 10 10 10 10 10 10 10 10 10 21 21 21 21 23
22 21 21 10 10 10 10 10 10 10 10 10 21 21 21 21 10 10 10 10 21 21 10 10 21 21 21 21 21 10 10 10 21 21 21 21 21 21 21 21 21 21 10 10 10 10 21 21 21 21 21 23
22 10 10 10 10 10 21 21 21 21 10 10 21 21 21 21 21 14 14 14 21 21 10 21 21 21 21 21 21 10 10 10 21 21 21 21 21 21 21 21 21 21 10 10 10 10 21 21 21 21 21 23
22 10 10 10 10 10 21 21 21 21 10 10 21 21 21 21 21 10 10 10 10 10 10 21 21 21 21 10 10 10 10 10 10 10 10 10 10 10 10 10 10 10 10 10 10 10 10 10 10 10 10 23
22 10 10 21 21 21 21 21 21 21 10 10 21 21 21 21 21 10 10 10 10 10 10 21 21 21 10 10 10 10 10 10 10 10 10 10 10 10 10 10 10 10 10 10 10 10 10 10 10 10 10 23
22 10 10 21 10 10 21 21 21 21 10 10 10 21 21 21 21 21 21 21 10 10 21 21 21 21 10 10 10 10 10 10 21 21 21 21 21 10 10 10 10 10 10 10 10 10 21 21 21 21 21 23
22 10 10 21 10 10 21 21 21 21 21 10 10 21 21 21 21 21 21 21 10 10 21 21 21 21 10 10 10 10 10 10 21 21 21 21 21 10 10 10 21 21 21 10 10 10 21 21 21 21 21 23
22 10 21 21 10 10 10 10 10 10 10 10 10 21 21 21 21 21 21 21 10 10 10 21 21 21 10 10 21 21 10 10 10 21 21 21 21 10 10 10 21 21 21 21 10 10 10 21 21 21 21 23
22 10 10 10 10 10 10 10 10 10 10 10 10 21 21 21 21 21 21 21 10 10 10 10 10 10 10 21 21 21 10 10 10 21 21 21 21 10 10 10 21 21 21 21 10 10 10 21 21 21 21 23
22 10 10 10 10 10 10 21 21 10 10 10 10 21 21 10 10 10 10 10 10 10 10 10 10 10 10 10 10 10 10 10 21 21 21 21 21 10 10 10 21 21 21 21 10 10 10 21 21 21 21 23
22 10 10 10 10 10 10 10 21 10 10 10 10 21 21 10 10 10 10 10 10 10 21 21 21 21 10 16 17 10 10 10 21 21 21 21 21 10 10 10 21 21 21 10 10 10 10 10 10 10 10 23
22 10 10 10 10 10 10 10 21 10 10 10 10 21 21 10 21 21 10 10 10 10 21 21 21 21 10 10 10 10 10 10 21 21 21 21 21 10 10 10 21 21 21 10 10 10 10 10 10 10 10 23
22 10 10 10 10 10 10 10 21 10 10 10 10 10 10 10 21 10 10 10 10 10 10 21 21 10 10 10 10 10 10 10 10 10 10 10 10 10 10 10 10 10 10 10 10 10 10 10 10 10 10 10 23
22 10 10 10 10 10 10 10 10 10 10 10 10 10 10 10 21 10 10 10 10 10 10 21 21 10 10 10 10 10 10 10 10 10 10 10 10 10 10 10 10 10 10 10 10 10 10 10 10 10 10 23
21 21 21 21 21 21 21 21 21 21 21 21 21 21 21 21 21 21 21 21 21 21 21 21 21 21 21 21 21 21 21 21 21 21 21 21 21 21 21 21 21 21 21 21 21 21 21 21 21 21 21 21