15 21 21 21 21 21 21 21 21 21 21 21 21 21 21 21 21 21 21 21 21 21 21 21 21 21 21 21 21 21 21 21 21 21 21 21 21 21 21 21 21 21 21 21 21 21 21 21 21 21 21 18
22 22 22 10 10 10 10 10 10 10 10 22 10 10 10 10 10 10 10 10 22 22 22 22 22 22 22 22 22 10 10 10 22 22 22 22 10 10 10 22 22 22 22 22 22 10 10 10 10 10 22 23
22 22 22 10 10 10 10 10 10 10 10 22 10 10 10 10 10 10 10 10 22 22 22 22 22 22 22 22 22 10 10 10 22 22 22 22 10 10 10 10 10 10 10 10 10 10 10 10 10 10 10 23
22 22 22 10 10 10 10 10 10 10 10 22 10 10 10 10 10 10 10 10 22 22 22 22 22 22 22 22 22 10 10 10 22 22 22 22 10 10 10 10 10 10 10 10 10 10 10 10 10 10 10 23
22 22 22 10 10 10 10 10 10 10 10 22 10 10 10 10 10 10 10 10 22 22 22 22 22 22 22 22 22 10 10 10 22 22 22 22 10 10 10 22 22 22 22 22 22 10 10 10 10 10 10 23
22 22 22 10 10 10 10 10 10 10 10 22 10 10 10 10 10 10 10 10 22 22 22 22 22 22 22 22 22 10 10 10 22 22 22 22 10 10 10 22 22 22 22 22 22 22 22 10 10 10 10 23
22 22 22 10 10 10 10 10 10 10 10 22 10 10 10 10 10 10 10 10 22 22 22 22 22 22 22 22 22 10 10 10 22 22 22 22 10 10 10 22 22 22 22 22 22 22 22 10 10 10 10 23
22 22 22 10 10 10 10 10 10 10 10 10 10 10 10 10 10 10 10 10 10 10 10 10 10 10 10 10 10 10 10 10 22 22 22 22 10 10 10 22 22 22 22 22 22 22 22 10 10 10 10 23
22 22 22 10 10 10 10 10 10 10 10 10 10 10 10 10 10 10 10 10 10 10 10 10 10 10 10 10 10 10 10 10 22 22 22 22 10 10 10 22 22 22 22 22 22 10 10 10 10 10 10 23
22 22 22 22 22 22 22 22 22 22 22 22 10 10 22 22 22 22 22 22 22 22 22 22 22 22 22 22 22 14 14 14 22 22 22 22 10 10 10 22 22 22 22 22 22 10 10 10 10 10 10 23
22 22 22 22 22 22 22 22 22 22 22 22 10 10 22 22 22 22 22 22 22 22 22 22 22 22 22 22 22 10 10 10 10 10 10 10 10 10 10 22 22 22 22 22 22 10 10 10 10 10 10 23
22 10 10 10 10 10 10 10 10 10 10 10 10 10 22 22 22 22 22 22 22 22 10 10 10 10 10 10 22 10 10 10 10 10 10 10 10 10 10 22 22 22 22 22 22 10 10 10 10 10 10 23
22 10 10 10 10 10 10 10 10 10 10 10 10 10 22 22 22 22 22 22 22 22 10 10 10 10 10 10 22 22 10 10 10 10 10 10 10 10 10 22 22 22 22 22 22 10 10 10 10 10 10 23
22 10 10 10 10 10 10 10 10 10 10 10 10 10 22 22 22 22 22 22 22 22 10 10 10 10 10 10 22 22 10 10 10 10 10 10 10 10 10 22 22 22 22 22 22 10 10 10 10 10 10 23
22 10 10 10 10 10 10 10 10 10 10 10 10 10 22 22 22 22 22 22 22 22 10 10 10 10 10 10 22 22 22 22 22 22 22 11 11 11 11 22 22 22 22 22 22 10 10 10 10 22 22 23
22 10 10 10 10 10 10 10 10 10 10 10 10 10 22 22 22 22 22 22 22 22 10 10 10 10 10 10 22 22 22 22 22 22 22 10 10 10 10 22 22 22 22 22 22 10 10 10 10 22 22 23
22 10 10 10 10 10 10 10 10 10 10 10 10 10 22 22 22 22 22 22 22 22 10 10 10 10 10 10 22 22 22 22 22 22 22 10 10 10 10 22 22 22 22 22 22 10 10 10 10 22 22 23
22 10 10 10 10 10 10 10 10 10 10 10 10 10 22 22 22 22 22 22 22 22 10 10 10 10 10 10 22 22 22 22 22 22 22 10 10 10 10 22 22 22 22 22 22 10 10 10 10 22 22 23
22 22 22 22 22 10 10 22 22 22 22 22 14 14 22 10 10 10 10 10 10 10 11 11 22 22 22 22 22 22 22 22 22 10 10 10 10 22 22 22 10 10 10 10 10 10 10 10 22 22 22 23
22 22 22 22 22 10 10 22 22 22 22 22 10 10 10 10 10 10 10 10 10 10 10 10 10 22 22 22 22 22 22 22 10 10 10 10 10 10 22 22 10 10 10 10 10 10 10 10 22 22 22 23
22 22 22 22 22 10 10 22 22 22 22 22 10 10 10 10 10 10 10 10 10 10 10 10 10 22 22 22 22 22 22 22 10 10 10 10 10 10 22 22 10 10 10 10 10 10 10 10 22 22 22 23
22 22 22 22 22 10 10 22 22 22 22 22 10 10 10 10 10 10 10 10 10 10 10 10 10 22 22 22 22 22 22 22 10 10 10 10 10 10 10 10 10 10 10 10 10 10 10 10 22 22 22 23
22 22 22 22 10 10 10 22 22 22 22 22 10 10 10 10 10 10 10 10 10 10 10 10 10 22 22 22 22 22 22 22 10 10 10 10 10 10 10 10 10 10 10 10 10 10 10 10 10 10 22 23
22 22 22 22 10 10 10 22 22 22 22 22 10 10 10 10 10 10 10 10 10 10 10 10 10 22 22 22 22 22 22 22 22 22 22 22 22 22 22 22 10 10 10 10 10 10 10 10 10 10 22 23
22 22 22 22 10 10 10 10 22 22 22 22 10 10 10 10 10 10 10 10 10 10 10 10 10 13 10 10 10 10 10 10 22 22 22 22 22 22 22 22 22 22 22 22 22 22 22 10 10 10 10 23
22 22 22 22 22 22 10 10 10 22 22 22 10 10 10 10 10 10 10 10 10 10 10 10 10 13 10 10 10 10 10 10 22 22 22 22 22 22 22 22 22 22 22 22 22 22 22 10 10 10 10 23
22 22 22 22 22 22 10 10 10 22 22 22 10 10 10 10 10 10 10 10 10 10 10 10 10 13 10 10 10 10 10 10 22 22 22 22 22 22 22 22 22 22 22 22 22 22 22 10 10 10 10 23
22 22 22 22 22 22 10 10 10 22 22 22 22 22 21 21 21 21 21 21 21 21 21 21 21 21 21 10 10 10 10 10 22 22 22 22 22 22 22 22 22 22 22 22 22 22 22 10 10 10 10 23
22 22 22 22 22 22 10 22 22 22 22 22 22 22 10 10 10 10 10 10 10 10 10 10 10 10 10 10 10 22 22 22 22 10 10 10 10 10 22 22 22 22 22 22 22 10 10 10 10 10 10 23
22 22 22 10 10 10 10 10 22 22 22 22 22 22 22 10 10 10 10 10 10 10 10 10 10 10 10 10 10 10 10 10 22 22 10 10 10 10 10 22 10 10 10 10 10 10 10 10 10 10 10 23
22 22 22 10 10 10 10 10 22 22 22 22 22 22 10 10 10 10 10 10 10 22 22 22 22 22 22 10 10 10 10 22 22 22 10 10 10 10 10 22 10 10 10 10 10 10 10 10 10 10 10 23
22 22 22 10 10 10 10 10 22 22 22 22 22 10 10 10 10 10 10 10 10 10 22 22 22 22 22 10 10 10 10 22 22 22 10 10 10 10 10 22 10 10 10 10 10 10 10 22 22 22 22 23
22 22 22 10 10 10 10 22 22 22 22 22 10 10 10 10 10 10 10 10 10 10 10 22 22 22 22 10 10 10 10 22 22 22 10 10 10 10 10 22 10 10 10 10 10 10 10 22 22 22 22 23
22 22 22 10 10 10 22 22 22 22 22 10 10 10 10 10 10 10 10 10 10 10 10 10 22 22 22 10 10 10 10 22 22 22 10 10 10 10 10 22 10 10 10 10 10 10 10 22 22 22 22 23
22 22 22 10 10 10 10 22 22 22 22 22 10 10 10 10 10 10 10 10 10 10 10 10 22 22 22 10 10 10 10 22 22 22 10 10 10 10 10 22 10 10 10 10 10 10 10 22 22 22 22 23
22 22 22 10 10 10 10 10 22 22 22 10 10 10 10 10 10 10 10 10 10 10 10 22 22 22 22 10 10 10 10 10 10 10 10 10 10 10 10 10 10 10 10 10 10 10 10 22 22 22 22 23
22 22 22 10 10 10 10 10 22 22 22 10 10 22 10 10 10 10 10 10 10 10 22 22 22 22 22 10 10 10 10 10 10 10 10 10 10 10 10 10 10 10 10 10 10 10 10 22 22 22 22 23
22 22 22 10 10 10 10 10 22 22 10 10 10 22 22 10 10 10 10 10 10 22 22 22 22 22 22 22 22 10 10 10 10 10 10 10 10 10 10 10 10 10 10 10 10 10 10 22 22 22 22 23
22 22 22 10 10 10 10 10 22 22 10 10 22 22 22 22 10 10 10 10 22 22 22 22 22 22 22 22 22 22 10 10 22 22 22 22 22 22 22 22 22 22 22 22 10 10 22 22 22 22 22 23
22 22 22 22 22 22 22 22 22 22 10 10 22 22 22 22 22 14 14 14 22 22 22 22 22 22 22 22 22 22 10 10 22 22 22 22 22 22 22 22 22 22 22 22 10 10 22 22 22 22 22 23
22 22 22 22 22 22 22 22 22 22 10 10 22 22 22 22 22 10 10 10 10 10 10 22 22 22 22 10 10 10 10 10 10 10 10 10 10 22 22 22 10 10 10 10 10 10 10 10 10 10 10 23
22 22 22 22 22 22 22 22 22 22 10 10 22 22 22 22 22 10 10 10 10 10 10 22 22 22 22 10 10 10 10 10 10 10 10 10 10 22 22 22 10 10 10 10 10 10 10 10 10 10 10 23
22 22 22 22 10 10 22 22 22 22 10 10 10 22 22 22 22 22 22 22 10 10 22 22 22 22 22 22 22 10 10 10 22 22 22 22 22 22 22 22 22 22 22 10 10 10 22 22 22 22 22 23
22 10 10 10 10 10 22 22 22 22 22 10 10 22 22 22 22 22 22 22 10 10 22 22 22 22 22 22 22 10 10 10 22 22 22 22 22 22 22 22 22 22 22 10 10 10 22 22 22 22 22 23
22 10 10 10 10 10 10 22 22 22 22 10 10 22 22 22 22 22 22 22 22 10 10 22 22 22 22 22 22 22 10 10 10 22 22 22 22 22 22 22 22 22 22 22 10 10 10 22 22 22 22 23
22 10 10 10 10 10 10 22 22 22 22 10 10 22 22 22 22 22 22 22 22 10 10 22 22 22 22 22 22 22 10 10 10 22 22 22 22 22 22 22 22 22 22 22 10 10 10 22 22 22 22 23
22 10 10 10 10 10 10 22 22 10 10 10 10 22 22 22 22 22 22 10 10 10 10 22 22 22 22 22 10 10 10 22 22 22 22 22 22 22 22 22 22 22 22 22 10 10 10 22 22 22 22 23
22 10 10 10 10 10 10 10 10 10 10 10 10 22 22 22 22 22 22 22 10 10 22 22 22 22 22 22 22 10 10 10 22 22 22 22 22 22 22 22 22 22 22 10 10 10 22 22 22 22 22 23
22 10 10 10 10 10 10 10 10 10 10 10 10 22 22 22 22 22 22 22 10 10 22 22 22 22 22 22 22 10 10 10 22 22 22 22 22 22 22 22 22 22 22 10 10 10 22 22 22 22 22 23
22 10 10 10 10 10 10 10 10 10 10 10 10 10 10 10 10 10 10 10 10 10 10 10 10 10 10 10 10 10 10 10 10 10 10 10 10 10 10 10 10 10 10 10 10 10 22 22 22 22 22 23
22 10 10 10 10 10 10 10 10 10 10 10 10 10 10 10 10 10 10 10 10 10 10 10 10 10 10 10 10 10 10 10 10 10 10 10 10 10 10 10 10 10 10 10 10 10 22 22 22 22 22 23
21 21 21 21 21 21 21 21 21 21 21 21 21 21 21 21 21 21 21 21 21 21 21 21 21 21 21 21 21 21 21 21 21 21 21 21 21 21 21 21 21 21 21 21 21 21 21 21 21 21 21 21